1111111111111111111111111111
1P00000000000000000000000001
1000001111111000000000000C01
1000001000001000000111000001
1000001000001000000100000001
1000001111001110000100000001
100000000000001000010000E001
100C000000000001000000000001
1111111111111111111111111111
