1111111111111111111111111111
1000000000000000000000000001
100000000001110000000N000001
1000110000001000000000000001
1000011110001000000C00000001
10000000P0001000001110000001
1000000000001000000011110001
10000000000000N0C0000000E001
100000000000000000000000N001
1111111111111111111111111111
