1111111111111111111111111111
1000000000000000000000001001
100C000000011100000000001C01
1000110000001000000000001101
1000011110001000000C00000001
10000000P0001000001110000001
1000000000001000000011110001
100000C0NNNNNN00C0000000E001
1000000000000000000000000001
1111111111111111111111111111
