1111111111111111111111111111
1P00000000000000000000000001
10000C0011100011100CCCC000E1
1000CC0100010100010000C00001
100C0C000110000110000C000001
10000C01000101000100C0000001
10000C0011100011100C00000001
1000000000000000000000000001
1111111111111111111111111111
